...
.
....................
....####.......####....
....#.............#....
....#......@......#....
.
.
....#.............#....
....#.............#....
....####.......####....
.
.
.