...............
.
....#.....#....
...............
..@....#.......
...............
....#.....#....
.
.